#=================#
E                 #
E                 #
EP    O  M      O #
#=== ========= ===#
#                 #
#                 #
#      M          #
# == ====L#===L== #
#         #       #
#         #       #
#         #       #
# R    O  # T     #
####L#### #######L#