#=================#
#                 E
#                 E
#   O            PE
#========L#===L===#
#         #       #
#         # O    R#
#  M   O  #===   ##
#====L=== #       #
#         # O    R#
# T     M #===   ##
#==== === #       #
#         # O    R#
#         #### ####