#=========#=======#
E         #       #
E         #       #
EP        # O     #
#==   L=  #===  = #
#                 #
#                 #
#  R      O  O M  #
# ====  =========L#
#                 #
#                 #
#  O     M      T #
#L==== ====== ====#
##               ##