#=================#
#                 E
#                 E
#     O     MO   PE 
#==L==============#
#                 #
#                 #
#     M           #
#L= =#=== ===#===L#
#    #       #    #
#    #R    O #    #
#    #=   ===#    #
#  O #       # T  #
# #######L####### #