#=================#
#                 E
#                 E
#   O            PE
#======== #===L===#
#         #       #
#         # O    R#
#  M   O  #===   ##
#====L===L#       #
#         # O    R#
# T     M #===   ##
#==== ====#       #
#         # O    R#
#         #### ####