#=================#
E                 #
E                 #
EPT               #
#==== R           #
#    ====   M     #
#         =====   #
#              ==L#
#   O T           #
# =======L        #
#                 #
#                 #
#    OM O  O  O   #
#L=============== #