#====#============#
E    #            #
E    #            #
EP   # T  O R O   #
#===L#=========== #
#                 #
#                 #
#      O   M  O   #
#L== ====#======= #
#        #        #
#        #        #
#                 #
#  T  OM   O  O   #
# ===============L#