#=================#
#                 E
#                 E
#    O           PE
# =======     ====#
#                 #
#    M         O  #
# =========   === #
#                 #
#  O           R  #
# ==========  === #
#                 #
#  O  O RO     T  #
#L########### ###L#