#=================#
#                 E
#                 E
#  O  M  O       PE
#L================#
#                 #
#                 #
#  O     O     O  #
# ===   ===   ===L#
#                 #
#                 #
#                 #
# T      R     O  #
#====  =====  === #